1111111111111
1000000000C11
1011111101111
1P0011E100001
1111111110111
1111111110111
111111111C111
1111111111111
