111111
10P0C1
10A001
10E001
111111