111111
1P01C1
100111
10E001
111111