1111111111111
1000000000C11
1011111101011
10DC01E00D001
1011011101101
10000P1C0DC01
1111111111111
