111111
10P0C1
1000E1
10E001
111111