111111
1000C1
100001
10E001
111111