111111
10P0C1
1000P1
10E001
111111