1111111111111
1P00000000011
1011111101011
101C01E001C01
1011011101101
1000001101C01
1111111111111
